R   1080  920

S ./textures/mushroom.xpm

NO ./textures/NO.xpm
SO ./textures/SO.xpm

F 15 , 100 , 15

WE ./textures/WE.xpm

C  50, 50 , 110  




EA ./textures/bluestone.xpm

                            11111111111111111111
                              101 101010000000001
                               1 110000200000001 
                                10000000000000001
                               1100000000000000001
                              1002000000000000001
                              100000000000001111
                             101100110011011111
                            10000000000000000001
                           11000N000000000000001
                          10000000002000100100001
                          1001000100010000001011
                           11 1111111 111111 11
